####################
#..................#
#.P.........H......#
#...################
#...#####..........#
#...##K..B...H.....#
#...#####..........#
#...##########.....#
#...##########.....#
#.......##...#.....#
#.......#....#.....#
#...H...#.H..#.....#
#..................#
####################