################
#..............#
#..E...........#
#..............#
#...K..........#
#..............#
#......P.......#
#...........E..#
#..............#
#......H.......#
################