################
#..............#
#..............#
#..............#
#...K..........#
#..............#
#..............#
#...........B..#
#..............#
#......H.......#
################
